Details,Posting Date,"Description",Amount,Type,Balance,Check or Slip #,
DEBIT,3/18/2016,"Payment to Chafe card ending in 1234 03/18",-2680.89,ACCT_XFER,3409.86,,
CREDIT,3/15/2016,"EMPLOYER INC    DIRECT DEP                 PPD ID: 1111111111",2590.73,ACH_CREDIT,6090.75,,
DEBIT,3/14/2016,"INVESTMENT SEC   TRANSFER   A5144608        WEB ID: 1234456789",-150.00,ACH_DEBIT,3500.02,,
DEBIT,3/6/2016,"ATM WITHDRAWAL                       001234  03/8888 DELANC",-60.00,ATM,3650.02,,
CREDIT,3/5/2016,"CA STATE         NYSTTAXRFD                 PPD ID: 1111111111",110.00,ACH_CREDIT,3710.02,,
DEBIT,3/4/2016,"BOOGLE           WALLET     US000NEI9T      WEB ID: C234567890",-1300.00,ACH_DEBIT,3600.02,,
